fileDescriptor	path	verboseDescription	generatingScript

#Directory of files in hypermutation project.  This file is parsed by a utility script.  Note all lines that start with # are ignored.  The first line needs to be a header
####FILES
#-------------INFO FILES
HYPERMUTATION_STATUS_IDS	files/hypermutationStatusIds	all cases by cancer type and with their hypermutation status	scriptToDoIds

CANCER_TYPE_INFO	files/infoFiles/cancerTypeInfo.txt	information about cancer-type and tmb	generated by chai

TCGA_CANCER_TYPE_INFO	files/infoFiles/tcgaCancerTypeInfo.txt

GENE_LENGTH_INFO	files/infoFiles/all_gene_coding_sequences.tsv

CASE_TMB_AND_MSI_STATS	files/infoFiles/mutations_TMB_and_MSI_stats.txt

DEP_MAP_DATA	files/infoFiles/projectAchillesDepMapData.csv

#-------------EXPECTATION

EXPECTED_MUTATION_INFO_BY_GENE	files/expectedMutationInfo/allHypermutatorsExpectedGeneMutInfo.tsv

###########--------------SIGNATURES

SIGNATURE_SPECTRUM	files/infoFiles/Stratton_signatures30.txt

IMPACT_SIGNATURE_DECOMPOSITIONS	files/infoFiles/impactSignatureCalls_Nov20_2019.tsv

TCGA_SIGNATURE_DECOMPOSITIONS	files/infoFiles/tcgaSigDecomposition.txt

EXOME_RECAPTURE_SIGNATURE_DECOMPOSITIONS	files/infoFiles/exomeRecaptureSigDecomposition.tsv

BRANCH_MUTATIONAL_SIGNATURES	/files/infoFiles/branchMutationalSignatures.tsv

#-------------MAFS

IMPACT_BASE_MAF	files/mafs/impact_mutations_maf_filtered

IMPACT_BASE_MAF_WITH_SYNONYMOUS	files/mafs/impact_mutations_maf_synonymous_included

ALL_EXOME_MAF	/

ALL_EXOME_HYPERMUTATOR_MAF	files/mafs/allHypermutatorsExome.maf

IMPACT_MAF_WITH_CNCF_ANNOTATION	files/mafs/combined_cncf_annotated.maf


####UTILITY SCRIPTS

SCRIPT_DEFINE_HYPERMUTATION_THRESHOLDS	scripts/utilityScripts/plotAndDefineHypermutationThresholds.R

SCRIPT_RUN_MUTATIONAL_SIGNATURES	

SCRIPT_ATTRIBUTE_MUTATIONS_TO_SIGNATURES	scripts/utilityScripts/attribute_mutations_to_signatures.py



##FIGURE 1

SCRIPT_GENERATE_PLOT_FIGURE_1bc	scripts/figure1/generate_cancer_types_and_sigs_figure#generatePlotsFigure1b_c	generates figure 1b and figure1c

SCRIPT_GENERATE_PLOT_FIGURE_1d	scripts/figure1/generate_n_oncogenic_by_hyper_not_hyper_#figure1d#	generates figure 1d

SCRIPT_GENERATE_PLOT_FIGURE_1e	scripts/figure1/generate_observed_vs_expected_figure_1e.ipynb		generates figure 1e

SCRIPT_GENERATE_PLOT_FIGURE_1f	scripts/figure1/generate_observed_vs_expected_figure_1f.ipynb		generates figure 1f

SCRIPT_PLOT_FIGURE1	scripts/figure1/FIGURE1_PLOTTING_FILES/plotFigure1.R	generates all figure 1 stuff

SCRIPT_PLOT_FIGURE1_SUPPLEMENTAL	scripts/figure1/FIGURE1_PLOTTING_FILES/plotFigure1.R	generates all figure 1 stuff

##FIGURE 2

